88 89 88 89 88 89 88 89 88 89 88 89 88 89 88 89 88 89 88 89 88 89 88 89 88 89 88
166 167 166 167 166 167 166 167 166 167 166 167 166 167 166 167 166 167 166 167 166 167 166 167 166 167 166
198 199 198 199 198 199 198 199 198 199 198 199 198 199 198 199 198 199 198 199 198 199 198 199 198 199 182
0 0 0 0 0 0 0 0 0 0 0 0 0 0 0 0 0 0 0 0 0 0 0 0 0 0 168
0 0 0 0 0 0 83 0 0 0 0 0 0 0 83 0 0 0 0 0 0 0 0 0 0 0 184
9 9 9 9 9 9 9 9 9 9 9 10 0 0 0 0 0 0 0 68 69 70 71 0 0 0 168
25 25 25 25 25 25 25 25 25 25 25 26 0 0 0 0 0 0 0 84 85 86 87 0 0 0 184
41 41 41 41 41 41 41 41 41 25 25 26 0 0 0 83 0 0 0 100 101 102 103 0 0 0 168
1 1 1 1 1 1 1 1 1 24 25 26 0 0 0 0 0 0 67 116 117 118 119 67 0 0 184
1 1 1 1 1 1 1 1 1 24 25 25 9 9 9 9 9 9 9 9 9 9 9 10 0 0 168
1 1 1 1 1 1 1 1 1 24 25 25 25 25 25 25 25 25 25 25 25 25 25 26 0 0 184
1 1 1 1 1 1 1 1 1 40 41 41 41 41 41 41 41 41 41 41 41 41 41 42 0 0 168
1 1 1 1 1 1 1 1 1 1 1 1 1 1 1 1 0 0 0 0 0 0 0 0 0 0 184
1 1 1 1 1 1 1 1 1 1 1 1 1 1 1 1 0 0 0 0 0 0 0 0 0 0 168
134 135 134 135 134 135 134 135 134 135 134 135 134 135 134 135 150 151 150 151 150 151 150 151 150 151 184