14 14 14 14 14 14 14 14 14 14 14 14 14 14 14 14
14 14 14 14 14 14 14 14 14 14 14 14 14 14 14 14
22 22 22 22 22 22 22 22 22 22 22 22 22 22 22 22
0 0 0 0 0 0 0 0 0 0 0 0 0 0 0 0
0 0 36 37 38 39 0 0 0 0 0 0 0 0 0 0
0 0 44 45 46 47 0 0 0 0 1 1 1 1 1 0
0 0 52 53 54 55 0 0 0 0 1 1 1 1 1 0
0 0 60 61 62 63 0 0 0 0 1 1 1 1 1 0
0 0 0 0 0 0 0 0 0 0 0 0 0 0 0 0
0 0 0 0 0 0 0 0 0 0 0 0 0 0 0 0
0 0 0 0 0 0 0 0 0 0 0 0 0 0 0 0
35 0 0 0 0 35 0 0 0 0 35 0 0 0 0 35
0 35 0 0 0 0 35 0 0 0 0 35 0 0 0 0
35 0 0 0 0 35 0 0 0 0 35 0 0 0 0 35
0 35 0 0 0 0 35 0 0 0 0 35 0 0 0 0
57 57 57 57 57 57 57 57 57 57 57 57 57 57 57 57

