42 42 42 42 42 42 42 42 42 42 42 42 42 42 42 42 42 42 42 42 42 42 42 42 42 42 42
42 42 42 42 42 42 42 42 42 42 42 42 42 42 42 42 42 42 42 42 42 42 42 42 42 42 42
42 42 42 42 42 42 0 1 2 3 7 8 9 10 11 12 4 4 4 6 42 42 42 42 42 42 42
42 42 42 42 42 42 13 14 15 16 20 21 22 23 24 25 17 17 17 19 42 42 42 42 42 42 42
42 42 42 42 42 42 26 27 28 29 33 34 35 36 37 38 64 53 53 32 42 42 42 42 42 42 42
42 42 42 42 42 42 39 53 53 53 46 47 48 49 50 51 64 53 53 45 42 42 42 42 42 42 42
42 42 42 42 42 42 39 53 53 53 59 60 61 62 60 60 53 53 53 45 42 42 42 42 42 42 42
42 42 42 42 42 42 39 53 53 53 53 71 72 73 74 53 53 53 53 45 42 42 42 42 42 42 42
42 42 42 42 42 42 39 53 53 53 53 65 66 67 68 53 53 53 53 45 42 42 42 42 42 42 42
42 42 42 42 42 42 39 53 53 53 53 53 69 70 53 53 30 31 56 45 42 42 42 42 42 42 42
42 42 42 42 42 42 39 53 53 53 53 53 53 53 53 53 43 44 57 45 42 42 42 42 42 42 42
42 42 42 42 42 42 39 53 53 53 53 53 53 53 53 53 56 57 53 45 42 42 42 42 42 42 42
42 42 42 42 42 42 52 53 53 53 53 53 54 55 53 53 53 53 53 58 42 42 42 42 42 42 42
42 42 42 42 42 42 42 42 42 42 42 42 42 42 42 42 42 42 42 42 42 42 42 42 42 42 42
42 42 42 42 42 42 42 42 42 42 42 42 42 42 42 42 42 42 42 42 42 42 42 42 42 42 42